2 2 2 2 2 2 2 2 2 2 2 2 2 2 2 2 2
2 0 0 1 0 4 3 5 1 5 1 2 5 5 0 0 2
2 0 2 5 4 4 1 4 0 4 0 2 4 3 4 0 2
2 5 0 0 0 4 0 0 0 0 0 4 0 5 5 5 2
2 4 2 2 1 5 0 2 0 2 0 1 0 2 4 4 2 
2 3 3 3 1 2 1 0 0 0 1 4 0 0 1 0 2
2 1 2 0 4 4 5 2 4 2 1 2 2 0 2 1 2
2 1 0 0 0 3 5 4 2 4 3 1 0 0 0 3 2
2 0 4 0 2 4 0 2 4 2 0 2 4 0 2 5 2
2 5 0 0 0 4 3 1 5 0 1 4 3 1 1 5 2
2 2 4 4 3 0 0 4 0 2 3 1 5 4 2 2 2 
2 0 0 1 3 2 3 0 0 0 5 4 5 5 0 1 2
2 0 4 5 4 2 3 2 0 4 0 2 4 5 2 0 2
2 0 0 3 0 4 3 0 5 1 1 4 3 5 0 0 2
2 2 2 2 2 2 2 2 2 2 2 2 2 2 2 2 2

