2 2 2 2 2 2 2 2 2 2 2 2 2 2 2 2 2
2 0 0 1 2 3 2 2 0 2 4 1 2 1 0 0 2
2 0 4 0 5 1 0 0 5 0 0 5 0 3 4 0 2
2 3 1 2 0 2 3 2 2 2 0 4 0 4 3 5 2 
2 2 5 3 0 3 1 2 2 2 1 2 0 2 1 2 2 
2 0 1 0 0 0 2 0 0 0 1 0 0 0 0 0 2 
2 2 5 2 0 2 0 2 4 2 0 4 0 4 0 4 2
2 4 1 2 4 2 0 4 2 4 0 2 2 2 5 2 2
2 2 3 2 0 2 0 2 4 2 0 2 0 2 1 2 2 
2 3 1 0 0 0 0 0 0 0 1 0 0 0 5 1 2
2 4 3 2 0 2 3 2 4 2 1 4 0 2 0 4 2
2 0 0 4 0 2 3 2 2 2 5 2 0 4 0 0 2
2 0 4 0 5 0 0 0 1 3 3 1 1 0 2 0 2
2 0 0 0 4 0 4 4 0 4 2 0 2 1 0 0 2
2 2 2 2 2 2 2 2 2 2 2 2 2 2 2 2 2
